      11111111111111111111
100000000E000000001111111111111
111111111111111111111
