111111111111111111111111111
100000000000000110E1
111111111111111111111111111
