NO ./sprites/chocbarre.xpm      

SO     ./sprites/cowskt2.xpm

WE          ./sprites/cdoor21.xpm

EA ./sprites/crate64.xpm    

F       220   ,  100 ,  0       

C   225 ,30,   010  


11111111111111111111111111111111111
10000000000000000000000000000000001
10000000000000011111111111111000001
10000000000000000000000000001000001
10000000000000011111111111111000001
10000000000000101000000000000000001
10000010000000000000000000000000001
1000000000N000101000000000000000001
10000000000000000000000000000000001
10000000000000000000000000000000001
11111111111111111111111111111111101
10000000000000000000000000000000001
11111111111111111111111111111111111
