NO ./sprites/chocbarre.xpm      

SO     ./sprites/cowskt2.xpm

WE          ./sprites/trees.xpm

EA ./sprites/crate64.xpm    

DO          ./sprites/cdoor21.xpm

F       220   ,  100 ,  0       

C   225 ,30,   010  


11111111111111111111111111111111111
10000000000000000000000000000000001
10000000000000011111111111111000001
10000000000000000000000000001000001
100000000DDD00011111111111111000001
1000000001D100101000000000001000001
1000001000000000000000000000000001
1000000000N00101000000000000000001
10000000000000000000000000000000001
10000000000000000000000000000000001
11111111111111111111111111111111101
11111111111111111111111111111111111




