WE  ./sprites/TongueClose64.xpm      

EA  ./sprites/TongueOpen64.xpm

NO  ./sprites/BrickWall64.xpm

SO  ./sprites/BrickWall64.xpm    

F       33, 12, 12

C   0, 0, 0

111111111111111111111111111
101S10000000000100000000001
101010001000000100000000001
1D1D100000000001111D1111111
100000000011000000000000001
100000000000000000001000001
111111111111111111111111111
