NO ./sprites/chocbarre.xpm      

SO     ./sprites/cowskt2.xpm

WE          ./sprites/trees.xpm

EA ./sprites/crate64.xpm    

F       1, 50, 32     

C   135, 206, 235


																	
111111111111111111111111111111111111111
10000000000000000000000000000000001
10000000000000011111111111111000001111
111110000000000000000000000000001000001
100000000DDD00011111111111111000001111
1100000001D100101000000000001000001
1100001000000000000000000000000001
1100000000N00101000000000000000001
10000000000000000000000000000000001
10000000000000000000000000000000001
11111111111111111111111111111111111




