NO ./sprites/chocbarre.xpm      

SO     ./sprites/cowskt2.xpm

WE          ./sprites/grass3.xpm

EA ./sprites/crate64.xpm    

F       220   ,  100 ,  0       

C   225 ,30,   010  


11111111111111111111111111111111111
10000000000000000000000000000000001
11111111100000000100000000000000001
10000000000000000000000000001111111
11111111100000000000000000000000001
10000000000000111100000000000000001
10000000000000000000000000000000001
10000000000000000000000000000000001
1000000000000000000W000000000000001
10000000000000000000000000000000001
10000000000000000000000000000000001
10000000000000000000000000000000001
10000000000000000000000000000000001
10000000000000000000000000000000001
10000000000000000000000000000000001
10000000000000000000000000000000001
10000000000000000000000000000000001
10000000000000000000000000000000001
10000000000000000000000000000000001
10000000000000000000000000000000001
10000000000000000000000000000000001
10000000000000000000000000000000001
10000000000000000000000000000000001
10000000000000000000000000000000001
10000000000000000000000000000000001
10000000000000000000000000000000001
10000000000000000000000000000000001
10000000000000000000000000000000001
10000000000000000000000000000000001
10000000000000000000000000000000001
10000000000000000000000000000000001
10000000000000000000000000000000001
10000000000000000000000000000000001
10000000000000000000000000000000001
10000000000000000000000000000000001
10000000000000000000000000000000001
10000000000000000000000000000000001
10000000000000000000000000000000001
10000000000000000000000000000000001
10000000000000000000000000000000001
10000000000000000000000000000000001
10000000000000000000000000000000001
10000000000000000000000000000000001
10000000000000000000000000000000001
10000000000000000000000000000000001
10000000000000000000000000000000001
10000000000000000000000000000000001
10000000000000000000000000000000001
10000000000000000000000000000000001
10000000000000000000000000000000001
10000000000000000000000000000000001
10000000000000000000000000000000001
10000000000000000000000000000000001
10000000000000000000000000000000001
10000000000000000000000000000000001
10000000000000000000000000000000001
10000000000000000000000000000000001
10000000000000000000000000000000001
10000000000000000000000000000000001
10000000000000000000000000000000001
10000000000000000000000000000000001
10000000000000000000000000000000001
10000000000000000000000000000000001
10000000000000000000000000000000001
10000000000000000000000000000000001
10000000000000000000000000000000001
10000000000000000000000000000000001
10000000000000000000000000000000001
10000000000000000000000000000000001
10000000000000000000000000000000001
10000000000000000000000000000000001
10000000000000000000000000000000001
10000000000000000000000000000000001
10000000000000000000000000000000001
10000000000000000000000000000000001
10000000000000000000000000000000001
10000000000000000000000000000000001
10000000000000000000000000000000001
10000000000000000000000000000000001
10000000000000000000000000000000001
10000000000000000000000000000000001
10000000000000000000000000000000001
10000000000000000000000000000000001
10000000000000000000000000000000001
10000000000000000000000000000000001
10000000000000000000000000000000001
10000000000000000000000000000000001
10000000000000000000000000000000001
10000000000000000000000000000000001
10000000000000000000000000000000001
10000000000000000000000000000000001
10000000000000000000000000000000001
10000000000000000000000000000000001
10000000000000000000000000000000001
10000000000000000000000000000000001
11111111111111111111111111111111111
