NO ./sprites/chocbarre.xpm      

SO     ./sprites/chocbarre.xpm

WE          ./sprites/chocbarre.xpm  

EA ./sprites/chocbarre.xpm       

F       220   ,  100 ,  0       

C   225 ,30,   010  

11111111111111111111111111111111111
10000000000000000000000000000000001
111111111000000001000000000000000001
        1000000000000000000000000001111111
11111111100000000000000000000000001
1000000000000000N000000000000000001
10000000000000000000000000000000001
10000000000000000000000000000000001
10000000000000000000000000000000001
11111111111111111111111111111111111