11111111111111
10N00000000001
10000111100001
11111111111111111
10000000011111
11111111111111
