F 0,0,0
C 0,0,0

NO ./sprites/liwWall.xpm      

SO ./sprites/liwWall.xpm

WE ./sprites/TongueOpen64.xpm

EA ./sprites/TongueClose64.xpm

1111111111111111111
10010010010010000W1
1011000001000000001
1001000001111011D11
1001111000001010001
1000000000001000001
1001111D11111000001
1D11000000000000001
1000000001000000011
1111111111111111111