WE ./sprites/grass3.xpm
EA ./sprites/trees.xpm
NO ./sprites/grass3.xpm
SO ./sprites/trees.xpm    

F   51, 26, 0
C   0, 153, 255


111111111111111111111111111
101S10000000000100000000001
1010D0001000000D00000000001
101010000011000111111111111
100000010000000000000000011
100000000000010000001000001
10000000000000000000D000001
101000000000000000001000001
100000000000100000100000001
100000000000000000000000111
111111111111111111111111111





