F 0,0,0
C 0,0,0

WE ./sprites/beam2.xpm      

EA ./sprites/dirt.xpm

NO ./sprites/stonemine.xpm

SO ./sprites/stonemine.xpm    

DO ./sprites/lockmine.xpm

1111111111111111111
10W100100100100D001
1011000001000001001
1001001001111101111
1001111000001001001
100000000000D001001
1001111111111001001
1111000000000001011
100D00000100000D001
1111111111111111111

